📺 二、 常见家电 (Household Appliances)
中文名称	英文名称	音标 (英式发音 / 美式发音)	发音要点备注
厨房电器			
1. 冰箱	Fridge / Refrigerator	/frɪdʒ/
/rɪˈfrɪdʒ.ə.reɪ.tər/ (英) / rɪˈfrɪdʒ.ə.reɪ.t̬ɚ/ (美)	Fridge 更口语化。Refrigerator 正式，重音在第二音节 /ˈfrɪdʒ/，美式结尾 /t̬ɚ/。
2. 烤箱	Oven	/ˈʌv.ən/	重音在第一个音节，o 发 /ʌ/ 短音。
3. 炉灶 (整体)	Cooker (英) / Stove (美)	/ˈkʊk.ər/
/stəʊv/ (英) / stoʊv/ (美)	Cooker 英式指带烤箱的灶；Stove 美式常用。Cook /ʊ/ 短音。
4. 炉灶 (台面)	Hob (英) / Stovetop (美)	/hɒb/ (英) / hɑːb/ (美)
/ˈstəʊv.tɒp/ (英) / ˈstoʊv.tɑːp/ (美)	Hob 英式指灶台面。
5. 微波炉	Microwave (Oven)	/ˈmaɪ.krə.weɪv/	重音在第一个音节 /maɪ/，wave 发 /weɪv/。
6. 洗碗机	Dishwasher	/ˈdɪʃˌwɒʃ.ər/ (英) / ˈdɪʃˌwɑː.ʃɚ/ (美)	重音在第一个音节 /dɪʃ/。
7. 抽油烟机	Extractor Fan / Range Hood	/ɪkˈstræk.tə ˌfæn/
/ˈreɪndʒ ˌhʊd/	Extractor 重音在第二音节 /ˈstræk/。Range Hood 美式常用。
8. 电水壶	Kettle	/ˈket.əl/	重音在第一个音节，e 发 /e/ 短音。
9. 烤面包机	Toaster	/ˈtəʊ.stər/ (英) / ˈtoʊ.stɚ/ (美)	重音在第一个音节，oa 发 /əʊ/ 或 /oʊ/。
10. 咖啡机	Coffee Maker	/ˈkɒf.i ˌmeɪ.kər/ (英) / ˈkɑː.fi ˌmeɪ.kɚ/ (美)	
11. 搅拌机	Blender	/ˈblen.dər/ (英) / ˈblen.dɚ/ (美)	重音在第一个音节。
12. 食物处理器	Food Processor	/ˈfuːd ˌprəʊ.ses.ər/ (英) / ˈfuːd ˌproʊ.ses.ɚ/ (美)	Processor 重音在第一个音节 /prəʊ/ 或 /proʊ/。
清洁电器			
13. 洗衣机	Washing Machine	/ˈwɒʃ.ɪŋ məˌʃiːn/ (英) / ˈwɑː.ʃɪŋ məˌʃiːn/ (美)	Washing 英式 /ɒ/ 美式 /ɑː/。Machine /əˌʃiːn/。
14. 烘干机	Tumble Dryer / Dryer	/ˌtʌm.bəl ˈdraɪ.ər/
/ˈdraɪ.ər/	Dryer 重音在第一个音节，y 发 /aɪ/。Tumble /ʌ/ 短音。
15. 吸尘器	Vacuum Cleaner / Hoover (英)	/ˈvæk.juːm ˌkliː.nər/
/ˈhuː.vər/	Vacuum 注意发音：/ˈvæk.juːm/ (vac-yoom)。Hoover 是英国常用品牌代指。
舒适电器			
16. 空调	Air Conditioner (AC)	/ˈeə kənˌdɪʃ.ən.ər/ (英) / ˈer kənˌdɪʃ.ən.ɚ/ (美)	重音在 Air 和 di (/dɪʃ/)。口语常说 A/C (/ˌeɪ ˈsiː/)。
17. 电风扇	Fan	/fæn/	短元音 /æ/。
18. 电暖器	Heater	/ˈhiː.tər/ (英) / ˈhiː.t̬ɚ/ (美)	重音在第一个音节，ea 发长音 /iː/。
影音/IT			
19. 电视机	Television / TV	/ˈtel.ɪˌvɪʒ.ən/
/ˌtiː ˈviː/	Television 重音在第一个音节 /tel/，sion 发 /ʒən/。TV 读字母音。
20. 收音机	Radio	/ˈreɪ.di.əʊ/ (英) / ˈreɪ.di.oʊ/ (美)	重音在第一个音节 /reɪ/。
21. 电吹风	Hair Dryer	/ˈheə ˌdraɪ.ər/ (英) / ˈher ˌdraɪ.ɚ/ (美)	Hair /heə/ 或 /her/；Dryer /aɪ/。
22. 熨斗	Iron	/ˈaɪ.ən/	重音在第一个音节，i 发