🍎 日常水果英语大全（25种）
中文	英文	音标 (英式/美式)	发音要点
苹果	Apple	/ˈæp.əl/	重音第一音节，/æ/嘴张大
香蕉	Banana	/bəˈnɑː.nə/ (英) / bəˈnæn.ə/ (美)	重音第二音节，美式尾音/næ/
橙子	Orange	/ˈɒr.ɪndʒ/ (英) / ˈɔːr.ɪndʒ/ (美)	/r/清晰发音，美式/ɔː/更长
葡萄	Grape	/ɡreɪp/	双元音/eɪ/滑动（"哎→衣"）
草莓	Strawberry	/ˈstrɔː.bər.i/ (英) / ˈstrɑː.ber.i/ (美)	三音节，英式/ɔː/ vs 美式/ɑː/
西瓜	Watermelon	/ˈwɔː.təˌmel.ən/ (英) / ˈwɑː.t̬ɚˌmel.ən/ (美)	美式/t̬ɚ/弹舌音
桃子	Peach	/piːtʃ/	长音/iː/，/tʃ/轻爆破
梨	Pear	/peə(r)/ (英) / per/ (美)	英式双元音/eə/（"哎→呃"）
柠檬	Lemon	/ˈlem.ən/	/e/短音（类似"勒"）
芒果	Mango	/ˈmæŋ.ɡəʊ/ (英) / ˈmæŋ.ɡoʊ/ (美)	鼻音/ŋ/，舌根抵软腭
猕猴桃	Kiwi	/ˈkiː.wiː/	两个长音/iː/
樱桃	Cherry	/ˈtʃer.i/	/tʃ/清辅音（类似"车"）
菠萝	Pineapple	/ˈpaɪn.æp.əl/	重音第一音节，/aɪ/双元音
椰子	Coconut	/ˈkəʊ.kə.nʌt/ (英) / ˈkoʊ.kə.nʌt/ (美)	三音节均弱读
蓝莓	Blueberry	/ˈbluː.bər.i/	/uː/长音（"乌"拖长）
石榴	Pomegranate	/ˈpɒm.ɪˌɡræn.ɪt/ (英) / ˈpɑː.məˌɡræn.ɪt/ (美)	重音第一音节，美式/ɑː/
李子	Plum	/plʌm/	/ʌ/短音（短促"啊"）
牛油果	Avocado	/ˌæv.əˈkɑː.dəʊ/ (英) / ˌæv.əˈkɑː.doʊ/ (美)	重音第三音节/kɑː/
木瓜	Papaya	/pəˈpaɪ.ə/	重音第二音节/paɪ/
荔枝	Lychee	/ˌlaɪˈtʃiː/ 或 /ˈliː.tʃiː/	常见两种读法
哈密瓜	Cantaloupe	/ˈkæn.tə.luːp/	重音第一音节，/uː/长音
百香果	Passion Fruit	/ˈpæʃ.ən ˌfruːt/	/ʃ/发音（类似"诗"）
山竹	Mangosteen	/ˈmæŋ.ɡə.stiːn/	/tiːn/发"teen"
柚子	Pomelo	/ˈpɒm.ɪ.ləʊ/ (英) / ˈpɑː.mə.loʊ/ (美)	英式尾音/ləʊ/ vs 美式/loʊ/
火龙果	Dragon Fruit	/ˈdræɡ.ən ˌfruːt/	/dr/连读（"捉"+"若"快速连读）
🏃 日常行为英语大全（30种）
中文含义	英文表达	音标 (英式/美式)	发音要点
晨间活动			
起床	Get up	/ˌɡet ˈʌp/	连读 /ɡeˈtʌp/
刷牙	Brush teeth	/ˌbrʌʃ ˈtiːθ/	/θ/咬舌音
洗脸	Wash face	/ˌwɒʃ ˈfeɪs/ (英) / ˌwɑːʃ ˈfeɪs/ (美)	美式/wɑːʃ/嘴张大
洗澡	Take a shower	/ˌteɪk ə ˈʃaʊ.ər/	/aʊ/双元音（"啊→乌"滑动）
穿衣服	Get dressed	/ˌɡet ˈdrest/	/e/短音
吃早餐	Have breakfast	/ˌhæv ˈbrek.fəst/	/brek/短促有力
日间活动			
上班/上学	Go to work/school	/ˌɡəʊ tə ˈwɜːk/ (英) / ˌɡoʊ tə ˈwɝːk/ (美)	美式/wɝː/卷舌
开会	Have a meeting	/ˌhæv ə ˈmiː.tɪŋ/	/iː/长音
写邮件	Write emails	/ˌraɪt ˈiː.meɪlz/	/aɪ/双元音
做午饭	Cook lunch	/ˌkʊk ˈlʌntʃ/	/ʊ/短音（嘴微圆）
午休	Take a nap	/ˌteɪk ə ˈnæp/	/æ/嘴张大
购物	Go shopping	/ˌɡəʊ ˈʃɒp.ɪŋ/ (英) / ˌɡoʊ ˈʃɑː.pɪŋ/ (美)	美式/ʃɑː/嘴张大
接孩子	Pick up kids	/ˌpɪk ʌp ˈkɪdz/	/pɪk/短促爆破
家务活动			
做饭	Cook dinner	/ˌkʊk ˈdɪn.ər/	/dɪn/短音
洗碗	Wash dishes	/ˌwɒʃ ˈdɪʃ.ɪz/ (英) / ˌwɑːʃ ˈdɪʃ.ɪz/ (美)	/dɪʃ/清辅音+咬舌音
洗衣服	Do laundry	/ˌduː ˈlɔːn.dri/ (英) / ˌduː ˈlɑːn.dri/ (美)	美式/ɑː/嘴张大
打扫房间	Clean the room	/ˌkliːn ðə ˈruːm/	/iː/长音
倒垃圾	Take out trash	/ˌteɪk aʊt ˈtræʃ/	/aʊ/双元音
晚间活动			
看电视	Watch TV	/ˌwɒtʃ ˌtiː ˈviː/ (英) / ˌwɑːtʃ ˌtiː ˈviː/ (美)	TV读字母音
看书	Read a book	/ˌriːd ə ˈbʊk/	/iː/长音
健身	Work out	/ˌwɜːk ˈaʊt/ (英) / ˌwɝːk ˈaʊt/ (美)	美式/wɝː/卷舌
散步	Take a walk	/ˌteɪk ə ˈwɔːk/ (英) / ˌteɪk ə ˈwɑːk/ (美)	美式/wɑː/嘴张大
打电话	Make a call	/ˌmeɪk ə ˈkɔːl/	/ɔː/圆唇音
上网	Surf the Internet	/ˌsɜːf ði ˈɪn.tə.net/ (英) / ˌsɝːf ði ˈɪn.t̬ɚ.net/ (美)	美式/sɝː/卷舌+t̬ɚ弹舌
听音乐	Listen to music	/ˌlɪs.ən tə ˈmjuː.zɪk/	/tə/弱读为/tə/
玩游戏	Play games	/ˌpleɪ ˈɡeɪmz/	/eɪ/双元音
写日记	Write a diary	/ˌraɪt ə ˈdaɪ.ər.i/	/aɪ/双元音（两次出现）
睡前活动			
刷牙	Brush teeth	/ˌbrʌʃ ˈtiːθ/	(同晨间)
设置闹钟	Set an alarm	/ˌset ən əˈlɑːm/	/lɑː/嘴张大
睡觉	Go to bed	/ˌɡəʊ tə ˈbed/	/e/短音