ğŸƒ æ—¥å¸¸è¡Œä¸ºè‹±è¯­ & éŸ³æ ‡é€ŸæŸ¥è¡¨ ğŸ“š
ä¸­æ–‡å«ä¹‰	è‹±è¯­è¡¨è¾¾ (åŠ¨è¯/çŸ­è¯­)	éŸ³æ ‡ (è‹±å¼å‘éŸ³ / ç¾å¼å‘éŸ³)	å‘éŸ³è¦ç‚¹ & å¤‡æ³¨
1. èµ·åºŠ	Get up	/ËŒÉ¡et ËˆÊŒp/	è¿è¯»æ—¶ /t/ å’Œ /ÊŒ/ ç»“åˆï¼Œç±»ä¼¼â€œgeh-tupâ€
Wake up	/ËŒweÉªk ËˆÊŒp/	/weÉªk/ åŒå…ƒéŸ³æ¸…æ™°
2. æ´—æ¼±	Wash (my) face	/ËŒwÉ’Êƒ (maÉª) ËˆfeÉªs/ (è‹±) / ËŒwÉ‘ËÊƒ (maÉª) ËˆfeÉªs/ (ç¾)	/wÉ’Êƒ/ æˆ– /wÉ‘ËÊƒ/
Brush (my) teeth	/ËŒbrÊŒÊƒ (maÉª) ËˆtiËÎ¸/	/Î¸/ å’¬èˆŒéŸ³ï¼æ˜“é”™ç‚¹
Take a shower / Have a shower	/ËŒteÉªk É™ ËˆÊƒaÊŠ.É™r/ / ËŒhÃ¦v É™ ËˆÊƒaÊŠ.É™r/	/ÊƒaÊŠ.É™r/ é‡éŸ³åœ¨ç¬¬ä¸€ä¸ªéŸ³èŠ‚
Comb (my) hair	/ËŒkÉ™ÊŠm (maÉª) ËˆheÉ™(r)/ (è‹±) / ËŒkoÊŠm (maÉª) Ëˆher/ (ç¾)	/heÉ™(r)/ æˆ– /her/
3. ç©¿è¡£	Get dressed	/ËŒÉ¡et Ëˆdrest/	/drest/ ä¸­ /e/ æ˜¯çŸ­éŸ³
Put on (clothes/shoes)	/ËŒpÊŠt ËˆÉ’n/ (...)/ (è‹±) / ËŒpÊŠt ËˆÉ‘Ën/ (...)/ (ç¾)	çŸ­è¯­åŠ¨è¯ï¼Œå®¾è¯­å¯æ”¾ä¸­é—´æˆ–åé¢ (put clothes on / put on clothes)
4. åƒ/å–	Have breakfast/lunch/dinner	/ËŒhÃ¦v Ëˆbrek.fÉ™st/ /ËˆlÊŒntÊƒ/ /ËˆdÉªn.É™r/	dinner ç¾å¼å¸¸è¯» /ËˆdÉªn.Éš/
Eat (something)	/iËt/	é•¿å…ƒéŸ³ /iË/
Drink (water/coffee)	/drÉªÅ‹k/	/Å‹k/ é¼»éŸ³+æ¸…è¾…éŸ³
Cook (a meal)	/kÊŠk/	çŸ­å…ƒéŸ³ /ÊŠ/
5. å·¥ä½œ/å­¦ä¹ 	Go to work/school	/ËŒÉ¡É™ÊŠ tÉ™ ËˆwÉœËk/ /ËˆskuËl/ (è‹±) / ËŒÉ¡oÊŠ tÉ™ ËˆwÉËk/ /ËˆskuËl/ (ç¾)	work ç¾éŸ³ /wÉËk/ å¸¦å·èˆŒ
Do homework	/ËŒduË ËˆhÉ™ÊŠm.wÉœËk/ (è‹±) / ËŒduË ËˆhoÊŠm.wÉËk/ (ç¾)	homework ä¸å¯æ•°åè¯
Study	/ËˆstÊŒd.i/	é‡éŸ³åœ¨ç¬¬ä¸€ä¸ªéŸ³èŠ‚
Have a meeting	/ËŒhÃ¦v É™ ËˆmiË.tÉªÅ‹/	/miË.tÉªÅ‹/ é•¿éŸ³ /iË/
6. äº¤é€š	Drive (a car)	/draÉªv/	åŒå…ƒéŸ³ /aÉª/
Take the bus/train/subway	/ËŒteÉªk Ã°É™ ËˆbÊŒs/ /ËˆtreÉªn/ /ËˆsÊŒb.weÉª/	subway è‹±å¼å¸¸ç”¨ underground /ËˆÊŒn.dÉ™.É¡raÊŠnd/
Walk	/wÉ”Ëk/ (è‹±) / wÉ‘Ëk/ (ç¾)	/É”Ë/ æˆ– /É‘Ë/
Ride a bike	/ËŒraÉªd É™ ËˆbaÉªk/	/raÉªd/ åŒå…ƒéŸ³ /aÉª/
7. å®¶åŠ¡	Do the laundry	/ËŒduË Ã°É™ ËˆlÉ”Ën.dri/ (è‹±) / ËŒduË Ã°É™ ËˆlÉ‘Ën.dri/ (ç¾)	laundry æŒ‡â€œè¦æ´—/å·²æ´—çš„è¡£ç‰©â€
Do the dishes / Wash dishes	/ËŒduË Ã°É™ ËˆdÉªÊƒ.Éªz/ / ËŒwÉ’Êƒ ËˆdÉªÊƒ.Éªz/	dishes å¤æ•°å½¢å¼
Clean (the room/house)	/kliËn/	é•¿å…ƒéŸ³ /iË/
Vacuum (the floor)	/ËˆvÃ¦k.juËm/	/j/ éŸ³æ¸…æ™°ï¼Œç±»ä¼¼â€œvac-yoomâ€
Take out the trash/rubbish	/ËŒteÉªk aÊŠt Ã°É™ ËˆtrÃ¦Êƒ/ /ËˆrÊŒb.ÉªÊƒ/	rubbish è‹±å¼ï¼›trash / garbage ç¾å¼
8. ä¼‘é—²/æ”¾æ¾	Watch TV	/ËŒwÉ’tÊƒ ËŒtiË ËˆviË/ (è‹±) / ËŒwÉ‘ËtÊƒ ËŒtiË ËˆviË/ (ç¾)	å­—æ¯ TV è¯»å…¨ç§° /ËŒtiË ËˆviË/
Listen to music	/ËŒlÉªs.É™n tÉ™ ËˆmjuË.zÉªk/	listen åå¿…é¡»åŠ  to
Read a book	/ËŒriËd É™ ËˆbÊŠk/	/riËd/ é•¿å…ƒéŸ³ /iË/
Play games (video/board)	/ËŒpleÉª ËˆÉ¡eÉªmz/	/pleÉª/ åŒå…ƒéŸ³ /eÉª/
Surf the Internet	/ËŒsÉœËf Ã°i ËˆÉªn.tÉ™.net/ (è‹±) / ËŒsÉËf Ã°i ËˆÉªn.tÌ¬Éš.net/ (ç¾)	the åœ¨å…ƒéŸ³å‰è¯» /Ã°i/
Go shopping	/ËŒÉ¡É™ÊŠ ËˆÊƒÉ’p.ÉªÅ‹/ (è‹±) / ËŒÉ¡oÊŠ ËˆÊƒÉ‘Ë.pÉªÅ‹/ (ç¾)	shopping /ÊƒÉ’p.ÉªÅ‹/ æˆ– /ÊƒÉ‘Ë.pÉªÅ‹/
9. å¤–å‡º/ç¤¾äº¤	Meet friends	/ËŒmiËt Ëˆfrendz/	/miËt/ é•¿éŸ³ /iË/
Go out	/ËŒÉ¡É™ÊŠ ËˆaÊŠt/ (è‹±) / ËŒÉ¡oÊŠ ËˆaÊŠt/ (ç¾)	åŒå…ƒéŸ³ /aÊŠ/
Have dinner (out)	/ËŒhÃ¦v ËˆdÉªn.É™r/	
See a movie / Go to the cinema	/ËŒsiË É™ ËˆmuË.vi/ / ËŒÉ¡É™ÊŠ tÉ™ Ã°É™ ËˆsÉªn.É™.mÉ™/ (è‹±)	cinema è‹±å¼ï¼›movies æˆ– theater ç¾å¼æ›´å¸¸ç”¨
10. ç¡è§‰	Go to bed	/ËŒÉ¡É™ÊŠ tÉ™ Ëˆbed/ (è‹±) / ËŒÉ¡oÊŠ tÉ™ Ëˆbed/ (ç¾)	/bed/ çŸ­å…ƒéŸ³ /e/
Go to sleep / Fall asleep	/ËŒÉ¡É™ÊŠ tÉ™ ËˆsliËp/ / ËŒfÉ”Ël É™ËˆsliËp/	asleep /É™ËˆsliËp/ é‡éŸ³åœ¨ç¬¬äºŒéŸ³èŠ‚
Turn off the light	/ËŒtÉœËn ËˆÉ’f Ã°É™ laÉªt/ (è‹±) / ËŒtÉËn ËˆÉ‘Ëf Ã°É™ laÉªt/ (ç¾)